11111111
10000001
10101011
10000001
11111111
11111111
10000001
11111111
